....#..*
#..$....
..*+-+.#
.$.-.-..
...+-+..
...$..##
#.#.###.
.....##.