....#..*
#..$....
..*+-+.#
.$.-.-..
...+-+..
....$.##
#.#.###.
.....##.